00 00 00 00 00 00 00 00 
00 00 00 00 00 00 00 00 
00 00 00 00 00 00 00 00 
f4 22 40 00 00 00 00 00
22 22 40 00 00 00 00 00
63 22 40 00 00 00 00 00
48 00 00 00 00 00 00 00 
e9 22 40 00 00 00 00 00
7d 23 40 00 00 00 00 00
d6 22 40 00 00 00 00 00
7b 22 40 00 00 00 00 00
22 22 40 00 00 00 00 00
8e 20 40 00 00 00 00 00 
36 62 65 64 31 62 33 32 
00 00 00 00 00 00 00 00 